#################################################
#.....#...........#...#.#.#...#...........#.....#
#####.#.####.###.####.#.#.#.####.###.####.#.#####
#.#...#.#.........#...#.#.#...#.........#.#...#.#
#.#.#.#.####.####.#.#.#.#.#.#.#.####.####.#.#.#.#
#.#.#.#.#.......#.#.#...#...#.#.#.......#.#.#.#.#
#...#...####.####.#.#.#.#.#.#.#.####.####...#...#
#.#.#.#.#.......#.#.#.#.#.#.#.#.#.......#.#.#.#.#
#.#.#.#.####.#.##.#...#...#...#.##.#.####.#.#.#.#
#.#.#.#.#.##.####.######.######.####.##.#.#.#.#.#
#.#...#...#.....#...............#.....#...#...#.#
#####.#########.#.#####.#.#####.#.#########.#####
#.......#.#.....#.......#.......#.....#.#.......#
#.#.#.#.#.#####.#######.@.#######.#####.#.#.#.#.#
#.#.#.#.#.....#.#.....##.##.....#.#.....#.#.#.#.#
#.......#.#######.###.......###.#######.#.......#
#######...............#####...............#######
#.......#########.#.###AAA###.#.#########.......#
#######...............##.##...............#######
#.......#.#######.###.......###.#######.#.......#
#.#.#.#.#.....#.#.....#####.....#.#.....#.#.#.#.#
#.#.#.#.#.#####.#######...#######.#####.#.#.#.#.#
#.......#.#.....#.......#.......#.....#.#.......#
#####.#########.#.#####.#.#####.#.#########.#####
#.#...#...#.....#...............#.....#...#...#.#
#.#.#.#.#.##.####.######.######.####.##.#.#.#.#.#
#.#.#.#.####.#.##.#...#...#...#.##.#.####.#.#.#.#
#.#.#.#.#.......#.#.#.#.#.#.#.#.#.......#.#.#.#.#
#...#...####.####.#.#.#.#.#.#.#.####.####...#...#
#.#.#.#.#.......#.#.#...#...#.#.#.......#.#.#.#.#
#.#.#.#.####.####.#.#.#.#.#.#.#.####.####.#.#.#.#
#.#...#.#.........#...#.#.#...#.........#.#...#.#
#####.#.####.###.####.#.#.#.####.###.####.#.#####
#.....#...........#...#.#.#...#...........#.....#
#################################################