#################################################
#.....#...........#...#.#.#...#...........#.....#
#####.#.#########.###.#.#.#.###.#########.#.#####
#.#...#.#.......#.#...#.#.#...#.#.......#.#...#.#
#.#.#.#.####.####.#.#.#.#.#.#.#.####.####.#.#.#.#
#.#.#.#.........#.#.#...#...#.#.#.........#.#.#.#
#...#.$.####.####.#.#.#.#.#.#.#.####.####.$.#...#
#.#.#.#.#.......#.#.#.#.#.#.#.#.#.......#.#.#.#.#
#.#.#.#.####.#.##.#...#...#...#.##.#.####.#.#.#.#
#.#.#.#.#########.######.######.#########.#.#.#.#
#.#...#...#.....#...............#.....#...#...#.#
#####.#########.#.#####.#.#####.#.#########.#####
#.......#.#.....#.......#.......#.....#.#.......#
#.#####.#.#####.#######...#######.#####.#.#####.#
#.#####.#.....#.#.....#####.....#.#.....#.#####.#
#.......#.#######.###.......###.#######.#.......#
#######...........#...##$##...#...........#######
#.......#########.#.###AAA###.#.#########.......#
#######...........#...#####...#...........#######
#.......#.#######.###.......###.#######.#.......#
#.#####.#.....#.#.....##.##.....#.#.....#.#####.#
#.#####.#.#####.#######.@.#######.#####.#.#####.#
#.......#.#.....#.......#.......#.....#.#.......#
#####.#########.#.#####.#.#####.#.#########.#####
#.#...#...#.....#...............#.....#...#...#.#
#.#.#.#.#########.######.######.#########.#.#.#.#
#.#.#.#.####.#.##.#...#...#...#.##.#.####.#.#.#.#
#.#.#.#.#.......#.#.#.#.#.#.#.#.#.......#.#.#.#.#
#...#.$.####.####.#.#.#.#.#.#.#.####.####.$.#...#
#.#.#.#.........#.#.#...#...#.#.#.........#.#.#.#
#.#.#.#.####.####.#.#.#.#.#.#.#.####.####.#.#.#.#
#.#...#.#.......#.#...#.#.#...#.#.......#.#...#.#
#####.#.#########.###.#.#.#.###.#########.#.#####
#.....#...........#...#.#.#...#...........#.....#
#################################################