#####################
#   #           #   #
# # # # ##### # # # #
# #   #   #   #   # #
### ##### # ##### ###
# #   #       #   # #
# # # # ## ## # # # #
#   #   # A #   #   #
# # # # ##### # # # #
# #   #       #   # #
### ##### # ##### ###
#.#   #   #   #   # #
# # # # ##### # # # #
#   #     @     #   #
#####################