#####################
#o..#...........#...#
#.#.#.#.#####.#.#.#.#
#.#...#...#...#...#.#
###.#####.#.#####.###
#.#...#.......#..o#.#
#.#.#.#.##.##.#.#.#.#
#...#...#AAA#...#...#
#.#.#.#.#####.#.#.#.#
#o#...#.......#...#.#
###.#####.#.#####.###
#.#...#...#...#...#o#
#.#.#.#.#####.#.#.#.#
#...#.....@.....#...#
#####################