#####################
#...#...........#...#
#.#.#.#.#####.#.#.#.#
#.#...#...#...#...#o#
###.#####.#.#####.###
#.#...#o......#...#.#
#.#.#.#.##.##.#.#.#.#
#o..#...#AAA#...#...#
#.#.#.#.#####.#.#.#.#
#.#...#.......#...#.#
###.#####.#.#####.###
#.#...#...#...#...#.#
#.#.#.#.#####.#.#.#.#
#...#.....@.....#..o#
#####################